C_...LLLLLLLLLLL
__......+...LLLL
####.+......LLLL
####........LLLL
LLLLLLL#....LLLL
LLLLLLL#....LLLL
............LLLL
............LLLL
............LLLL
............LLLL
LLLLL..LLLLLLLLL
............LLLL
............LLLL
.+..........LLLL
............LLLL
............LLLL
......+.....LLLL
............LLLL
LL.+........LLLL
LLL.........LLLL
LLL.........LLLL
LLL.........LLLL
LLL.........LLLL
LLL.........LLLL
LLL.........LLLL
LLLLLLLLLLLLLLLL