C_...LLLLLLLLLLL
__......+...LLLL
####.+......LLLL
####........LLLL
LLLLLLL#....LLLL
LLLLLLL#....LLLL
............LLLL
............LLLL
............LLLL
............LLLL